gia's	/ˈdʒiəz/
giacalone	/ˈdʒɑkɑˌɫoʊˌni/
giacco	/ˈdʒɑˌkoʊ/
giacinta	/ˈdʒɑtʃinˌtɑ/
giacobbe	/ˈdʒɑkoʊˌbi/
giacomelli	/dʒəkoʊˈmɛˌɫi/
giacometti	/dʒəkəˈmɛˌti/
giacomini	/dʒəkoʊˈmiˌni/
giacomo	/ˈdʒɑkəˌmoʊ/
giaconda	/ˌdʒiəˈkɑnˌdɑ/
giaconda's	/ˈdʒiəˈkɑndəz/
giacone	/ˌdʒiəˈkoʊni/
giaimo	/ˈdʒeɪmoʊ/
gialanella	/dʒəɫɑˈnɛɫə/
giamatti	/ˌdʒiəˈmɑˌti/
giambalvo	/ˈdʒɑmbɑɫˌvoʊ/
giambra	/ˈdʒɑmbɹə/
giambrone	/ˈdʒɑmbɹoʊni/
giammalva	/ˌdʒiəˈmɔɫvə/
giammarco	/ˈdʒɑmɑɹˌkoʊ/
giammarino	/dʒəmɑˈɹiˌnoʊ/
giampa	/ˈdʒɑmpə/
giampaolo	/dʒɑmˈpaʊˌɫoʊ/
giampapa	/dʒɑmˈpɑˌpɑ/
giampietro	/ˈdʒɑmpiˌtɹoʊ/
gian	/ˈdʒiɑn/
giancana	/dʒiəˈkɑˌnɑ/
giancarlo	/ˌdʒiæŋˈkɑɹˌɫoʊ/
giancola	/ˈdʒɑŋkoʊɫɑ/
gianelli	/dʒəˈnɛˌɫi/
gianfrancesco	/ˌdʒɑnfɹænˈtʃɛsˌkoʊ/
gianfranco	/ˈdʒiənˈfɹænˌkoʊ/, /dʒənˈfɹɑnˌkoʊ/
giang	/ˈdʒɑŋ/, /dʒiˈɑŋ/
giangrande	/ˈdʒɑnɡɹændi/
gianini	/dʒəˈniˌni/
gianino	/dʒəˈniˌnoʊ/
giannattasio	/ˈdʒɑnɑˌtɑsiˌoʊ/
giannelli	/dʒəˈnɛˌɫi/
giannetti	/dʒəˈnɛˌti/
giannetto	/dʒəˈnɛˌtoʊ/
gianni	/ˈdʒɑˌni/, /ˈdʒjɑˌni/, /dʒiˈɑˌni/
giannini	/dʒəˈniˌni/
giannino	/ˌdʒiəˈniˌnoʊ/
giannola	/ˈdʒɑnoʊɫə/
giannone	/ˈdʒɑnoʊˌni/
giannotti	/ˈdʒɑnoʊˌti/
gianotti	/ˈdʒɑnoʊˌti/
giant	/ˈdʒaɪənt/
giant's	/ˈdʒaɪənts/
giants	/ˈdʒaɪənts/
giants'	/ˈdʒaɪənts/
giap	/ˈdʒjæp/, /dʒiˈæp/
giaquinto	/ˈdʒɑkwintoʊ/
giard	/ˈdʒɑɹd/, /dʒiˈɑɹd/
giardi	/dʒiˈɑɹdi/
giardina	/ˈdʒɑɹdinə/
giardini	/dʒɝˈdini/
giardino	/dʒɝˈdinoʊ/
giarratano	/ˌdʒɑɹəˈtɑnoʊ/
giarrusso	/dʒɑˈɹusoʊ/
gib	/ˈɡɪb/
gibas	/ˈdʒaɪbəz/
gibb	/ˈdʒɪb/
gibb's	/ˈɡɪbz/
gibbard	/ʒɪˈbɑɹd/
gibbens	/ˈɡɪbənz/
gibberish	/ˈɡɪbɝɪʃ/
gibbins	/ˈdʒɪbɪnz/
gibble	/ˈdʒɪbəɫ/
gibbon	/ˈɡɪbən/
gibboney	/ˈdʒɪbəni/
gibbons	/ˈɡɪbɪnz/
gibbs	/ˈɡɪbz/
gibbs's	/ˈɡɪbzɪz/
gibby	/ˈdʒɪbi/
gibe	/ˈdʒaɪb/
gibeau	/ʒɪˈboʊ/
gibeault	/ʒɪˈboʊ/
giberson	/ˈdʒɪbɝsən/
gibert	/ˈɡɪbɝt/
gibes	/ˈdʒaɪbz/
gibian	/ˈɡɪbiən/
gibian's	/ˈɡɪbiənz/
giblen	/ˈɡɪbɫən/
gibler	/ˈdʒɪbəɫɝ/, /ˈdʒɪbɫɝ/
giblet	/ˈdʒɪbɫət/
giblin	/ˈdʒɪbɫɪn/
gibney	/ˈdʒɪbni/
giboney	/ˈdʒɪbəni/
gibraltar	/dʒɪˈbɹɔɫtɝ/
gibran	/dʒɪˈbɹɑn/
gibson	/ˈɡɪbsən/
gibson's	/ˈɡɪbsənz/
gibsons	/ˈɡɪbsənz/
gick	/ˈdʒɪk/
gidcumb	/ˈɡɪdkəm/
giddens	/ˈɡɪdənz/
giddings	/ˈɡɪdɪŋz/
giddy	/ˈɡɪdi/
gide	/ˈʒid/
gidel	/ˈɡaɪˌdɛɫ/
gideon	/ˈɡɪdiən/
gidget	/ˈɡɪdʒət/
gidley	/ˈɡɪdɫi/
gidney	/ˈɡɪdni/
gidwitz	/ˈɡɪdwɪts/
giebel	/ˈɡibəɫ/
giebler	/ˈɡibəɫɝ/, /ˈɡibɫɝ/
gieck	/ˈdʒik/
giefer	/ˈɡifɝ/
gieger	/ˈɡiɡɝ/
giegerich	/ˈɡiɡɝɪk/
giel	/ˈdʒiɫ/
gielgud	/ˈɡiɫɡəd/
gielow	/ˈdʒiɫoʊ/
gienger	/ˈɡindʒɝ/
gienow	/ˈɡinaʊ/
gier	/ˈdʒɪɹ/
giere	/ˈdʒɪɹ/
gierhart	/ˈɡɪɹhɑɹt/
gierke	/ˈdʒɪɹk/
gierman	/ˈɡɪɹmən/
giersch	/ˈɡɪɹʃ/
gies	/ˈɡiz/
giesbrecht	/ˈɡisbɹɪkt/
giese	/ˈdʒis/
giesecke	/ˈɡisɪk/
gieseke	/ˈɡisɪk/
gieseler	/ˈɡisəɫɝ/
gieselman	/ˈɡisəɫmən/
giesen	/ˈɡisən/
gieser	/ˈɡisɝ/
giesey	/ˈdʒisi/
gieske	/ˈdʒisk/
giesler	/ˈɡisəɫɝ/, /ˈɡisɫɝ/
giessen	/ˈɡizsən/
gietzen	/ˈɡitzən/
giff	/ˈɡɪf/
giffard	/ˈɡɪfɝd/
giffen	/ˈɡɪfən/
gifferd	/ˈɡɪfɝd/
giffin	/ˈɡɪfɪn/
gifford	/ˈɡɪfɝd/
gifford's	/ˈɡɪfɝdz/
giffords	/ˈɡɪfɝdz/
giffy	/ˈɡɪfi/
gift	/ˈɡɪft/
gift-horse	/ˈɡɪftˈhɔɹs/
gifted	/ˈɡɪftəd/, /ˈɡɪftɪd/
gifting	/ˈɡɪftɪŋ/
giftrust	/ˈɡɪfˌtɹəst/
gifts	/ˈɡɪfs/, /ˈɡɪfts/
giftware	/ˈɡɪftˌwɛɹ/
gig	/ˈɡɪɡ/
gigabyte	/ˈɡɪɡəˌbaɪt/
gigabytes	/ˈɡɪɡəˌbaɪts/
gigaflop	/ˈɡɪɡəˌfɫɑp/
gigaflops	/ˈɡɪɡəˌfɫɑps/
gigante	/dʒiˈɡɑnti/
gigantic	/dʒaɪˈɡænɪk/, /dʒaɪˈɡæntɪk/
giger	/ˈɡaɪɡɝ/
gigging	/ˈɡɪɡɪŋ/
giggle	/ˈɡɪɡəɫ/
giggled	/ˈɡɪɡəɫd/
giggles	/ˈɡɪɡəɫz/
giggling	/ˈɡɪɡəɫɪŋ/, /ˈɡɪɡɫɪŋ/
giggly	/ˈɡɪɡəɫi/
gigi	/ˈdʒidʒi/
giglia	/ˈdʒiɡɫiə/
giglio	/ˈdʒɪɡɫioʊ/
gigliotti	/dʒiɡɫiˈoʊti/
gignac	/ˈɡɪɡnək/
gignoux	/ɡɪˈnu/
gigolo	/ˈdʒɪɡəɫoʊ/
gigot	/ˈdʒɪɡət/
gigot's	/ˈdʒɪɡəts/
gigs	/ˈɡɪɡz/
giguere	/dʒiˈɡɛɹeɪ/
gikas	/ˈɡaɪkəz/
gil	/ˈɡɪɫ/
gila	/ˈɡiɫə/
gilardi	/dʒiˈɫɑɹdi/
gilb	/ˈɡɪɫb/
gilberg	/ˈɡɪɫbɝɡ/
gilbert	/ˈɡɪɫbɝt/
gilbert's	/ˈɡɪɫbɝts/
gilberta	/dʒiɫˈbɛɹtə/
gilberte	/ˈɡɪɫbɝt/
gilberti	/dʒiɫˈbɛɹti/
gilbertina	/dʒiɫbɝˈtinə/
gilbertine	/dʒiɫbɝˈtini/
gilberto	/ɡɪɫˈbɛɹˌtoʊ/, /ɡɪɫˈbɝtoʊ/
gilbertson	/ˈɡɪɫbɝtsən/
gilbey	/ˈɡɪɫbi/
gilbo	/ˈdʒiɫboʊ/
gilboy	/ˈɡɪɫbɔɪ/
gilbreath	/ˈɡɪɫˌbɹɛθ/
gilbreth	/ˈɡɪɫbɹɪθ/
gilbride	/ˈɡɪɫˌbɹaɪd/
gilby	/ˈɡɪɫbi/
gilchrest	/ˈɡɪɫkɝɪst/
gilchrist	/ˈɡɪɫkɹɪst/
gilcrease	/ɡɪɫˈkɹis/
gilcrest	/ˈɡɪɫkɝɪst/, /ˈɡɪɫkɹɛst/
gild	/ˈɡɪɫd/
gilda	/ˈɡɪɫdə/
gilday	/ˈɡɪɫˌdeɪ/
gildea	/ˈdʒiɫdiə/
gilded	/ˈɡɪɫdɪd/
gilden	/ˈɡɪɫdən/
gilder	/ˈɡɪɫdɝ/
gilder's	/ˈɡɪɫdɝz/
gildersleeve	/ˈɡɪɫdɝˌsɫiv/
gilding	/ˈɡɪɫdɪŋ/
gildner	/ˈɡɪɫdnɝ/
gildon	/ˈɡɪɫdən/
gile	/ˈɡaɪɫ/
gilead	/ɡɪˈɫid/
giles	/ˈdʒaɪɫz/
gilfillan	/ˌɡɪɫˈfɪɫən/
gilford	/ˈɡɪɫfɝd/
gilger	/ˈɡɪɫɡɝ/
gilgit	/ˈɡɪɫdʒɪt/
gilgore	/ˌɡɪɫˈɡɔɹ/
gilham	/ˈɡɪɫhəm/
gilhooly	/ˈɡɪɫhuɫi/
gilkerson	/ˈɡɪɫkɝsən/
gilkes	/ˈɡɪɫks/
gilkeson	/ˈɡɪɫkɪsən/
gilkey	/ˈɡɪɫki/
gilkison	/ˈɡɪɫkɪsən/
gilkisons	/ˈɡɪɫkɪsənz/
gill	/ˈɡɪɫ/
gill's	/ˈɡɪɫz/
gillam	/ˈɡɪɫəm/
gillan	/ˈɡɪɫən/
gilland	/ˈɡɪɫənd/
gillard	/ʒɪˈɫɑɹd/
gillaspie	/ˈɡɪɫəspi/
gillaspy	/ˈɡɪɫəspi/
gille	/ˈɡaɪɫ/
gillean	/ˈɡɪɫən/
gilleland	/ˈɡɪɫɪɫænd/
gillem	/ˈɡɪɫɪm/
gillen	/ˈɡɪɫən/
gillen's	/ˈɡɪɫənz/
gillentine	/ˈɡɪɫənˌtaɪn/
giller	/ˈɡɪɫɝ/
gilleran	/ˈɡɪɫɝæn/
gillers	/ˈɡɪɫɝz/
gilles	/ˈʒiɫ/
gillespie	/ɡəˈɫɛspi/
gillet	/ˈɡɪɫɪt/
gillett	/dʒɪˈɫɪt/
gillette	/dʒɪˈɫɛt/
gillette's	/dʒɪˈɫɛts/
gilley	/ˈɡɪɫi/
gillham	/ˈɡɪɫhəm/
gilliam	/ˈɡɪɫiəm/
gillian	/ˈdʒɪɫiən/
gilliand	/ˈɡɪɫiənd/
gilliard	/ˈɡɪɫiɝd/
gilliardi	/ɡɪɫˈjɑɹdi/
gilliatt	/ˈɡɪɫiæt/
gillick	/ˈɡɪɫɪk/
gillie	/ˈɡɪɫi/
gillies	/ˈɡɪɫiz/
gillig	/ˈɡɪɫɪɡ/
gilligan	/ˈɡɪɫəɡən/
gilligan's	/ˈɡɪɫəɡənz/
gillihan	/ˈɡɪɫəhæn/
gillikin	/ˈɡɪɫəkən/
gillilan	/ˈɡɪɫəɫən/
gilliland	/ˈɡɪɫəɫənd/
gillin	/ˈɡɪɫɪn/
gillingham	/ˈɡɪɫɪŋˌhæm/
gillings	/ˈɡɪɫɪŋz/
gillinov	/ˈɡɪɫɪnɑv/
gillins	/ˈɡɪɫɪnz/
gillis	/ˈɡɪɫɪs/
gillison	/ˈɡɪɫɪsən/
gillispie	/ɡəˈɫɛspi/
gillman	/ˈɡɪɫmən/
gillmore	/ˈdʒiɫmɔɹ/
gillock	/ˈɡɪɫək/
gillogly	/ˈɡɪɫəɡɫi/
gillon	/ˈɡɪɫən/
gillooly	/ˈɡɪɫuɫi/
gillooly's	/ˈɡɪɫuɫiz/
gillott	/ˈɡɪɫət/
gillotti	/dʒiˈɫoʊti/
gills	/ˈɡɪɫz/
gillson	/ˈɡɪɫsən/
gillum	/ˈɡɪɫəm/
gilly	/ˈɡɪɫi/
gilman	/ˈɡɪɫmən/
gilmartin	/ɡɪɫˈmɑɹtɪn/
gilmer	/ˈɡɪɫmɝ/
gilmore	/ˈɡɪɫmɔɹ/
gilmour	/ʒɪɫˈmʊɹ/
gilpatrick	/ˈɡɪɫpətɹɪk/, /ɡɪɫˈpætɹɪk/
gilpin	/ˈɡɪɫpɪn/
gilreath	/ˈɡɪɫɹɛθ/
gilroy	/ˈɡɪɫˌɹɔɪ/
gilsdorf	/ˈɡɪɫsdɔɹf/
gilson	/ˈɡɪɫsən/
gilstrap	/ˈɡɪɫstɹəp/
gilt	/ˈɡɪɫt/
giltner	/ˈɡɪɫtnɝ/
gilts	/ˈɡɪɫts/
gilvin	/ˈɡɪɫvɪn/
gilyard	/ʒəɫˈjɑɹd/
gimbel	/ˈɡɪmbəɫ/
gimenez	/dʒiˈmeɪnɛz/
gimlet	/ˈɡɪmˌɫɛt/
gimli	/ˈɡɪmɫi/
gimlin	/ˈɡɪmɫɪn/
gimme	/ˈɡɪmi/
gimmick	/ˈɡɪmɪk/
gimmickry	/ˈɡɪmɪkɹi/
gimmicks	/ˈɡɪmɪks/
gimmicky	/ɡɪˈmɪki/
gimpel	/ˈɡɪmpəɫ/
gin	/ˈdʒɪn/
gina	/ˈdʒinə/
gina's	/ˈdʒinəz/
ginandjar	/dʒɪˈnændʒɝ/
ginas	/ˈdʒinəz/
ginder	/ˈɡaɪndɝ/
gindin	/ˈɡɪndɪn/
gindlesperger	/ˈɡɪndəɫspɝɡɝ/
gines	/ˈdʒaɪnz/
ginevra	/dʒɪˈnɛvɹə/
ging	/ˈdʒɪŋ/
gingell	/ˈɡɪŋɡəɫ/
ginger	/ˈdʒɪndʒɝ/
gingerbread	/ˈdʒɪndʒɝˌbɹɛd/
gingerich	/ˈɡɪŋɡɝɪk/
gingerly	/ˈdʒɪndʒɝɫi/
gingery	/ˈdʒɪndʒɝi/
gingham	/ˈɡɪŋəm/
ginghams	/ˈɡɪŋəmz/
gingko	/ˈɡɪŋˌkoʊ/
gingles	/ˈdʒɪŋɡəɫz/
gingold	/ˈdʒɪnˌɡoʊɫd/, /ˈɡɪnˌɡoʊɫd/
gingras	/ˈɡɪŋɡɹəz/
gingrich	/ˈɡɪŋɡɹɪtʃ/
gingrich's	/ˈɡɪŋɡɹɪtʃɪz/
gingriches	/ˈɡɪŋɡɹɪtʃɪz/
ginley	/ˈdʒɪnɫi/
ginn	/ˈdʒɪn/
ginned	/ˈdʒɪnd/
ginnell	/dʒɪˈnɛɫ/
ginnie	/ˈdʒɪni/
ginning	/ˈdʒɪnɪŋ/
ginny	/ˈdʒɪni/
gino	/ˈdʒinoʊ/
ginocchio	/dʒiˈnoʊkioʊ/
ginsberg	/ˈɡɪnsbɝɡ/
ginsburg	/ˈɡɪnzbɝɡ/
ginsburg's	/ˈɡɪnzbɝɡz/
ginseng	/ˈdʒɪnˌsɛŋ/
ginsu	/ˈɡɪnsu/
ginsu's	/ˈɡɪnsuz/
gintel	/ˈdʒɪnˌtɛɫ/
ginter	/ˈɡɪntɝ/
ginther	/ˈɡɪnðɝ/
ginting	/ˈdʒɪnˈtɪŋ/
ginty	/ˈdʒɪnti/
gintz	/ˈɡɪnts/
ginyard	/ˈdʒɪnˌjɑɹd/
ginza	/ˈɡɪnzə/
ginzberg	/ˈɡɪnzbɝɡ/
gioia	/ˈdʒoʊjə/
gionet	/dʒiˈoʊneɪt/
gionfriddo	/dʒoʊnˈfɹidoʊ/
giordani	/dʒɔɹˈdɑni/
giordano	/dʒɔɹˈdɑnoʊ/
giorgi	/ˈdʒɔɹdʒi/
giorgia	/ˈdʒɔɹdʒə/
giorgio	/ˈdʒɔɹdʒioʊ/
giovanelli	/dʒoʊvɑˈnɛɫi/
giovanetti	/dʒoʊvɑˈnɛti/
giovannetti	/dʒoʊvɑˈnɛti/
giovanni	/ˌdʒioʊˈvɑni/, /dʒəˈvɑni/
giovanni's	/ˌdʒioʊˈvɑniz/, /dʒəˈvɑniz/
giovanniello	/dʒoʊˌvɑniˈɛɫoʊ/
giovannini	/dʒoʊvɑˈnini/
giovannoni	/dʒoʊvɑˈnoʊni/
giovenco	/dʒoʊˈvɛnkoʊ/
giovinazzo	/dʒoʊviˈnɑzoʊ/
gipe	/ˈdʒaɪp/
gipp	/ˈdʒɪp/
gipper	/ˈɡɪpɝ/
gipple	/ˈdʒɪpəɫ/
gipson	/ˈɡipsən/
giraffe	/dʒɝˈæf/
giraffes	/dʒɝˈæfs/
giraldo	/dʒɪˈɹɑɫdoʊ/
girard	/dʒɝˈɑɹd/
girardi	/dʒɪˈɹɑɹdi/
girardin	/ˌʒɪˈɹɑɹdɛn/
girardot	/ˈʒɪˌɹɑɹdoʊ/
giraud	/ʒaɪˈɹoʊ/
gird	/ˈɡɝd/
girder	/ˈɡɝdɝ/
girders	/ˈɡɝdɝz/
girding	/ˈɡɝdɪŋ/
girdle	/ˈɡɝdəɫ/
girdler	/ˈɡɝdəɫɝ/, /ˈɡɝdɫɝ/
girdley	/ˈɡɝdɫi/
girdner	/ˈɡɝdnɝ/
girds	/ˈɡɝdz/
gire	/ˈɡaɪɹ/
giren	/ˈdʒɪɹən/, /ˈɡɪɹən/
girgenti	/dʒɪɹˈdʒɛnti/
girgis	/ˈɡɝɡɪs/
girija	/ˌɡɪˈɹidʒə/
girl	/ˈɡɝɫ/
girl's	/ˈɡɝɫz/
girlfriend	/ˈɡɝɫˌfɹɛnd/
girlfriend's	/ˈɡɝɫˌfɹɛndz/
girlfriends	/ˈɡɝɫˌfɹɛndz/
girlhood	/ˈɡɝɫˌhʊd/
girlie	/ˈɡɝɫi/
girlish	/ˈɡɝɫɪʃ/
girlishly	/ˈɡɝɫɪʃɫi/
girls	/ˈɡɝɫz/
girls'	/ˈɡɝɫz/
girobank	/ˈɡɪɹoʊˌbæŋk/
girod	/ʒɝˈɑd/
giroir	/ʒaɪɹˈwɑɹ/
girolamo	/dʒɪɹoʊˈɫɑmoʊ/
giroldi	/ɡɪˈɹoʊɫdi/
giroldi's	/ɡɪˈɹoʊɫdiz/
giron	/ˈʒɪɹən/
gironde	/dʒɝˈɔnd/
girouard	/ˈʒaɪɹuɝd/
giroux	/ʒɪˈɹu/
girozentrale	/ɡɪˈɹoʊzənˌtɹɑɫ/
girsky	/ˈɡɝski/
girt	/ˈɡɝt/
girten	/ˈɡɝtən/
girth	/ˈɡɝθ/
girtman	/ˈɡɝtmən/
girton	/ˈɡɝtən/
girvan	/ˈɡɝvən/
girven	/ˈɡɝvən/
girvin	/ˈɡɝvɪn/
gisbert	/ˈdʒɪsbɝt/, /ˈɡɪsbɝt/
giscard	/ɡɪˈskɑɹd/, /ʒɪˈskɑɹ/
gisclair	/ʒɪˈskɫɛɹ/
gisela	/ˈɡizəɫə/
gisella	/dʒɪˈsɛɫə/
giselle	/ʒɪˈsɛɫ/
gisenyi	/dʒɪˈsɛni/, /dʒɪˈsɛnji/
gish	/ˈdʒɪʃ/, /ˈɡɪʃ/
gisi	/ˈdʒisi/
gisler	/ˈɡɪsəɫɝ/, /ˈɡɪsɫɝ/
gismondi	/dʒisˈmoʊndi/
gissendanner	/ˈɡɪsɪndənɝ/
gissi	/ˈɡɪsi/
gist	/ˈdʒɪst/
gisu	/ˈdʒɪsu/
git	/ˈɡɪt/
gitana	/dʒiˈtænə/
gitano	/ɡɪˈtɑnoʊ/
gitano's	/ɡɪˈtɑnoʊz/
gitchell	/ˈdʒɪtʃəɫ/
githa	/ˈdʒɪðə/
githens	/ˈɡɪθənz/
github	/ˈɡɪthəb/
gitlin	/ˈdʒɪtɫɪn/
gittelman	/ˈɡɪtəɫmən/
gittens	/ˈɡɪtənz/
gitter	/ˈɡɪtɝ/
gittings	/ˈdʒɪtɪŋz/
gittins	/ˈdʒɪtɪnz/
gittis	/ˈdʒɪtəs/, /ˈɡɪtɪs/
gittleman	/ˈɡɪtəɫmən/
gittleman's	/ˈɡɪtəɫmənz/
gittler	/ˈɡɪtɫɝ/
gitto	/ˈdʒitoʊ/
giudice	/ˈdʒudɪsi/
giudici	/ˈdʒudɪtʃi/
giuffre	/ˈdʒufɹi/
giuffre's	/ˈdʒufɹiz/
giuffrida	/ˈdʒufɹidə/
giuliani	/ˌdʒuɫiˈɑni/
giuliani's	/ˌdʒuɫiˈɑniz/
giuliano	/ˌdʒuɫiˈɑnoʊ/
giulio	/ˈdʒuɫioʊ/
giunta	/ˈdʒuntə/
giurescu	/ˌdʒuˈɹɛsku/
giuseppe	/dʒɪˈsɛpi/
giusti	/ˈdʒusti/
giusto	/ˈdʒustoʊ/
givan	/ˈɡɪvən/
give	/ˈɡɪv/
giveaway	/ˈɡɪvəˌweɪ/
giveaways	/ˈɡɪvəˌweɪz/
giveback	/ˈɡɪvˌbæk/
givebacks	/ˈɡɪvˌbæks/
given	/ˈɡɪvən/, /ˈɡɪvɪn/
givenchy	/ɡɪˈvɛntʃi/
givenness	/ˈɡɪvənəs/
givens	/ˈɡɪvənz/
givens's	/ˈɡɪvənzɪz/
giver	/ˈɡɪvɝ/
givers	/ˈɡɪvɝz/
gives	/ˈɡɪvz/
giveth	/ˈɡɪvɛθ/
givhan	/ˈɡɪvhən/
givin'	/ˈɡɪvɪn/
giving	/ˈɡɪvɪŋ/
giving-feast	/ˈɡɪvɪŋˌfist/
givins	/ˈɡɪvɪnz/
givler	/ˈɡɪvɫɝ/
giza	/ˈɡizə/, /ˈɡɪzə/
gizbert	/ˈɡɪzbɝt/
gizbert's	/ˈɡɪzbɝts/
gizmo	/ˈɡɪzˌmoʊ/
gizmos	/ˈɡɪzmoʊz/
gizzard	/ˈɡɪzɝd/
gizzi	/ˈdʒitsi/
